&&&&&&&&&&&&&&&&&&&&&&&&&&&&&&&&&&&&
&                                  &
&                                  &
&                                  &
&                                  &
&                                  &
&                                  &
&                                  &
&XXXXXXXXXXXXXXXXXXXXXXXXXXXXXXX---&
&&&&&&&&&&&&&&&&&&&&&&&&&&&&&&&&   &
&                                  &
&                               ---&
&                                  &
&                                  &
&                               ---&
&                                  &
&                                  &
&---&&&&&&&&&&&&&&&&&&&&&&&&&&&&&&&&
&   &&&&&&&&&&&&&&&&&&&&&&&&&&&&&&&&
&                                  &
&---                               &
&                                  &
&                                  &
&---                               &
&                                  &
&                                  &
&&&&&&&&&&&&&&&&&&&&&&&&&&&&&&&&&&&&
