&&&&&&&&&&&&&&&&&&&&&&&&&&&&&&&&&&&&
&                                  &
&                                  &
&                                  &
&                                  &
&                                  &
&                                  &
&                                  &
&                                  &
&                                  &
&&&&&&&&&&&&&&&    &&&&&&&&&&&&&&&&&
&&&&&&&&&&&&&&&    &&&&&&&&&&&&&&&&&
&                                  &
&                                  &
&                                  &
&                                  &
&                                  &
&                                  &
&                                  &
&                                  &
&                                  &
&&&&&&&&&&&&&&&&&&&&&&&&&&&&&    &&&
&&&&&&&&&&&&&&&&&&&&&&&&&&&&&    &&&
&                                  &
&                                  &
&                                  &
&                                  &
&                                  &
&                                  &
&                                  &
&                                  &
&                                  &
&&&&&&&&&&&&&&&&&&&&&&&&&&&&&&&&&&&&
