&&&&&&&&&&&&&&&&&&&&&&&&&&&&&&&&&&&&
&AAAAAAAAAAAAAAAAAAAAAAAAAAAAAAAAAA&
&                                  &
&                                  &
&                                  &
&                                  &
&                                  &
&VVVVVVVVVVVVVVVVVVVVVVVVVVVVVVVVVV&
&XXXXXXXXXXXXXXXXXXXXXXXXXXXXXXXXXX&
&&&&&&&&&&&&&&&    &&&&&&&&&&&&&&&&&
&                                  &
&                                  &
&                                  &
&                                  &
&                                  &
&                                  &
&                                  &
&&&&&&&&&&&&&&&&&&&&&&&&&&&&&    &&&
&&&&&&&&&&&&&&&&&&&&&&&&&&&&&    &&&
&                                  &
&                                  &
&                                  &
&                                  &
&                                  &
&                                  &
&                                  &
&&&&&&&&&&&&&&&&&&&&&&&&&&&&&&&&&&&&
