&&&&&&&&&&&&&&&&&&&&&&&&&&&&&&&&&&&&
&>>>>>>>>>>>>>>>>>>>>>>>>>>>>>>>>>>&
&~~~~~~~~~~~~~~~~~~~~~~~~~~~~~~~~~~&
&~~~~~~~~~~~~~~~~~~~~~~~~~~~~~~~~~~&
&~~~~~~~~~~~~~~~~~~~~~~~~~~~~~~~~~~&
&~~~~~~~~~~~~~~~~~~~~~~~~~~~~~~~~~~&
&~~~~~~~~~~~~~~~~~~~~~~~~~~~~~~~~~~&
&<<<<<<<<<<<<<<<<<<<<<<<<<<<<<<<<<<&
&xxxxxxxxxxxxxxxxxxxxxxxxxxxxxxx   &
&&&&&&&&&&&&&&&&&&&&&&&&&&&&&&&&   &
&AAAAAAAAAAAAAAAAAAAAAAAAAAAAAAAAAA&
&..................................&
&..................................&
&..................................&
&..................................&
&..................................&
&VVVVVVVVVVVVVVVVVVVVVVVVVVVVVVVVVV&
&   XXXXXXXXXXXXXXXXXXXXXXXXXXXXXXX&
&   &&&&&&&&&&&&&&&&&&&&&&&&&&&&&&&&
&1222222222222222222222222222222223&
&8000000000000000000000000000000004&
&8000000000000000000000000000000004&
&8000000000000000000000000000000004&
&8000000000000000000000000000000004&
&8000000000000000000000000000000004&
& 66666666666666666666666666666666 &
&BBBBBBBBBBBBBBBBBBBBBBBBBBBBBBBBBB&
